00000001000000000000010000000
01101101011111011111010110110
01000100000000000000000100010
01010101010101010101010101010
01010101010101010101010101010
01010101010101010101010101010
00000000010001010001000000000
01111101011011011011010111110
00000000010001010001000000000
01010101010101010101010101010
01010101010101010101010101010
01010101010101010101010101010
01000100000000000000000100010
01101101011111011111010110100
00000001000000000000010000000